15 15
0 0
14 14
S . . # . . . . . . . . . . .
# # . # . # # # . . # # # . .
. . . . . K . # . . . . . . .
. # # # # # . # . . # # # # .
. . . . . # . K . . . . . # .
. # . # . # . # # . . # . # .
. # . # . # . . . # . # . K .
. # . . . K . # . . . . . . .
. . . # . . . # K . . . . K .
# . . . . . . . . . . . . . .
. # # # # . # # # # # # # # .
. . . . . . K . . . . . . . .
. # # # # # # # # # K # # # #
. . . . . . . . . . . . . . .
# # # # # # # # # # # # # # G